enemies: 10
name: test_level
tilesheet: my_horror.png
song: test.mp3
map:
WWWWWWWWWWWWWWWWWWWWWWWWWW
W..X.....................W
W........................W
W........................W
W..E.....................W
W........W.....E.........W
W........W...............W
W........W...............W
W........W....S..........W
WWWWWWWWWWWWWWWWWWWWWWWWWW
endmap